########################################
#                                      #
#                                      #
#--    --------------------------    --#
#                                      #
#                                      #
#--                                  --#
#                                      #
#                                      #
#--    --------------------------    --#
#                                      #
#                                      #
#--                                  --#
#                                      #
#                                      #
#--    --------------------------    --#
#                                      #
#                                      #
#--                                  --#
#                                      #
#              e                       #
#--    --------------------------    --#
#                                      #
#                                      #
#--                                  --#
#                                      #
#                         b            #
#--    --------------------------    --#
#                                      #
#                                      #
#--                                  --#
#                                      #
#                                      #
#--    --------------------------    --#
#                                      #
#                                      #
#--                                  --#
#                                      #
#                                      #
########################################
