#                   |                  #
#                   |                  #
#                                      #
#                   |       e          #
#                   |                  #
#                                      #
#            e      |                  #
#                   |                  #
#                                      #
#                   |                  #
#                   |                  #
#                                      #
#                   |                  #
#                   |     e            #
#                                      #
#                   |                  #
#                   |                  #
#                                      #
#b                  |                  #
#                   |                  #
#                                      #
#                   |                  #
#                   |                  #
#                                      #
#                   |                  #
#                   |                  #
#                                      #
#                   |                  #
#                   |                  #
#                                      #
#                   |                  #
#                   |                  #
#                                      #
#                   |                  #
#                   |                  #
#                                      #
#                   |                  #
#                   |                  #
#                                      #
#                   |                  #
#                   |                  #
#                                      #
#                   |                  #
#                   |                  #
#                                      #
#                   |                  #
#                   |                  #